S..........XX...X.X.X..XX.
.XXXXXXX.X.XX.X.X....X....
.X.....WXX..X.X.X..X...X.X
...XXXWWWWX...X...X..X.X..
XXX...XXXXXXXXXXXXXXXXXXX.
EW..X.....................