S................
.XXXXXXXXXXXXX.X.
.XWXW..........X.
.X.XXXXXXXXXXX.X.
.X....XW.....X.X.
.X.X.XXXX.XX.X.X.
.X.X...X...X.X.X.
...XXX.XWX.X.X.X.
.XXXWX.XEXXX.X...
.XWX.X.XXX.X.X.X.
.X...X..W..X.X.X.
.X.X.XXXXXXX.X.X.
.X.X.........XWX.
.X.XXXXXXXXXXXXX.
.X.............X.
.XXXXXXXXXXXXX.X.
............WX...